Name,Volume,Ask Size,Ask Price,Bid Size,Bid Price,Last Price,Shares Matched,Shares Routed
IGV,976849,600,83.48,100,83.47,83.47,922971,53878
NVDX,894218,10865,13.63,5500,13.62,13.62,881350,12868
UVIX,784216,288,5.71,3113,5.70,5.71,618374,165842
SING,696377,100,0.10,100,0.09,0.10,678901,17476
VHAI,616881,100,0.04,400,0.04,0.04,556808,60073
NVDQ,587940,21531,5.76,1154,5.75,5.76,548811,39129
UVXY,515704,500,27.72,150,27.70,27.71,490169,25535
BBJP,474090,2200,55.80,351,55.79,55.78,470623,3467
VXX,450972,211,51.96,112,51.93,51.95,390964,60008
BITX,433359,500,29.22,300,29.17,29.18,422867,10492
FBTC,386842,460,53.36,150,53.34,53.35,344012,42830
VIXY,378814,1901,12.86,1300,12.85,12.85,375459,3355
SVIX,359791,100,28.21,900,28.18,28.20,339904,19887
USHY,340319,27068,36.75,29649,36.74,36.74,340311,8
IEFA,305176,2200,73.05,8800,73.04,73.04,304376,800
INDA,211622,3400,55.52,4100,55.51,55.52,206308,5314
ITB,205061,100,113.14,15,113.11,113.10,204409,652
SVXY,184435,300,50.17,201,50.14,50.15,181252,3183
ETHU,179415,3300,6.63,3100,6.61,6.62,173941,5474
ARKB,176307,500,60.94,750,60.90,60.85,176160,147
USMV,154299,300,87.25,800,87.24,87.25,154299,0
COWZ,127683,2596,55.11,200,55.10,55.10,127169,514
ARKG,120970,239,25.04,300,25.03,25.04,120860,110
GOVZ,105224,39300,11.70,15347,11.69,11.70,105224,0
GOVT,98089,201960,23.26,206138,23.25,23.26,90457,7632
PAVE,88503,300,37.48,700,37.47,37.47,87503,1000
EZU,78567,1490,48.48,933,48.47,48.47,78567,0
AAAU,72479,35500,24.42,20803,24.41,24.41,72189,290
MOAT,70181,30,90.50,27,90.49,90.50,70181,0
CALF,58628,2200,44.19,200,44.15,44.15,55518,3110
IYT,58527,401,64.10,606,64.06,64.09,44422,14105
ACWV,54116,282,108.64,200,108.59,108.59,54116,0
QUAL,52918,100,170.83,100,170.80,170.79,52918,0
FLOT,51935,11532,50.84,8365,50.83,50.84,51935,0
LVHI,48307,80,29.64,500,29.55,29.60,48157,150
EFV,47379,300,53.70,1400,53.69,53.69,47379,0
CBOE,42942,1,201.06,5,200.87,200.93,42499,443
SPYI,40698,600,49.63,110,49.60,49.60,40647,51
OMFL,39541,793,50.09,636,50.08,50.06,39466,75
FETH,38130,1500,27.07,1400,27.05,27.09,38130,0
MTUM,38111,100,188.86,100,188.82,188.81,37851,260
NEAR,38016,1600,50.86,7200,50.85,50.86,38016,0
DFIC,34874,5168,26.45,1700,26.44,26.44,34674,200
TLTW,34289,1000,26.62,2074,26.61,26.62,34289,0
QDTE,32755,230,42.30,1,42.26,42.27,32563,192
NOBL,30713,310,99.78,100,99.76,99.73,30613,100
QMMY,27541,1000,20.35,1000,20.28,20.28,27541,0
BBCA,26171,100,67.24,136,67.22,67.23,26171,0
BUFR,26161,3200,28.98,1100,28.97,28.98,22431,3730
ICOW,26147,100,30.20,300,30.15,30.12,23976,2171
ARKQ,25677,200,53.17,500,53.13,53.14,25677,0
HYD,24670,723,52.35,700,52.34,52.34,24456,214
FBCG,24281,3257,40.34,84,40.30,40.29,24281,0
EFG,24051,61,101.71,200,101.65,101.60,23987,64
TYA,23493,700,14.31,600,14.30,14.30,23493,0
AAPX,23218,563,31.94,763,31.88,31.82,23218,0
BTCO,22900,900,61.03,1000,60.96,60.98,18689,4211
BOXX,22898,2312,108.15,5915,108.14,108.14,22898,0
BBEU,22432,920,59.23,600,59.22,59.21,22337,95
JCPB,21541,1300,47.61,300,47.60,47.60,20453,1088
IDV,19211,300,28.58,800,28.57,28.56,16363,2848
ICSH,19203,8041,50.58,13530,50.57,50.58,19203,0
JBBB,18487,4000,48.41,3300,48.40,48.40,18487,0
HEFA,17972,500,33.84,500,33.83,33.83,17971,1
VUSB,17824,2302,49.67,16006,49.66,49.66,17824,0
KJAN,17635,400,35.54,3400,35.43,35.43,17635,0
IBHE,16929,4700,23.21,3957,23.20,23.20,16929,0
ITA,16527,306,140.83,200,140.76,140.77,16527,0
XSHD,16073,349,14.99,1000,14.97,14.98,16071,2
JMST,16056,2000,50.82,2300,50.81,50.81,16056,0
HODL,15971,700,69.03,800,68.95,69.00,15971,0
REM,15599,850,22.89,150,22.88,22.87,15599,0
MLN,14354,205,18.17,700,18.16,18.16,14354,0
BTCW,14226,2200,64.96,700,64.76,64.78,14226,0
SMIN,13843,9,80.91,23,80.86,80.86,13649,194
ICVT,13825,277,79.25,600,79.21,79.25,13825,0
RDVI,13698,5000,23.54,17,23.50,23.51,13698,0
HYMU,13240,400,23.04,543,23.03,23.03,13240,0
IBMQ,13163,500,25.35,600,25.34,25.34,13073,90
EEMV,12914,320,58.52,300,58.51,58.50,12914,0
QCJL,12676,3000,19.95,85,19.87,19.86,12676,0
EFAV,12657,105,72.76,65,72.73,72.74,12635,22
IBHH,12600,400,23.30,300,23.29,23.29,12600,0
BBHY,12361,600,46.24,300,46.23,46.24,12361,0
KNG,12352,700,51.80,400,51.72,51.76,12352,0
IEO,12184,100,95.28,100,95.26,95.19,12184,0
HYDB,12137,300,46.83,700,46.82,46.82,12137,0
SLVP,11818,500,11.94,1000,11.90,11.90,11818,0
IBHF,11623,500,23.03,200,23.02,23.03,11623,0
DIHP,11612,749,26.38,2800,26.37,26.36,8997,2615
PICK,11471,31,37.99,513,37.94,37.96,11171,300
VLUE,11302,200,101.92,900,101.89,101.90,10474,828
ICLO,11026,900,25.66,500,25.65,25.65,11026,0
BUFD,10315,700,24.39,800,24.35,24.38,10115,200
FLBL,10223,700,24.21,1100,24.20,24.18,10223,0
VNM,10141,500,11.87,6800,11.86,11.85,10140,1
ZIVB,10057,200,21.11,100,21.06,21.04,10057,0
ESGV,9943,203,95.81,100,95.78,95.73,9843,100
CETH,9613,3000,13.53,6700,13.51,13.55,9613,0
MPRO,9559,300,29.17,300,29.14,29.08,6975,2584
FFLC,9463,600,43.08,1500,42.97,43.04,9462,1
JMUB,9324,700,50.94,900,50.93,50.93,9324,0
IBHI,9266,400,23.42,153,23.39,23.40,9266,0
ETHV,9245,1500,39.64,400,39.60,39.68,9245,0
TMFC,9178,317,52.99,300,52.96,52.95,8374,804
FLQM,9090,400,52.49,12,52.46,52.47,9090,0
IBHG,8989,400,22.24,1150,22.23,22.24,8989,0
XDTE,8679,1000,51.38,219,51.32,51.34,8677,2
AJUL,8664,3000,26.14,3100,26.07,26.13,8664,0
IBMM,8542,774,26.07,500,26.06,26.06,8542,0
BBAX,8483,1200,48.96,130,48.94,48.89,8185,298
ESML,8481,308,39.13,600,39.08,39.10,8481,0
EMHY,8413,100,37.77,500,37.75,37.74,8413,0
EZBC,8286,700,35.40,300,35.36,35.35,8286,0
TRTY,8057,900,25.61,99,25.50,25.50,8057,0
GCOW,7839,600,34.84,200,34.82,34.82,7839,0
QMAR,7754,700,27.59,901,27.50,27.57,7754,0
DFIS,7693,300,25.09,300,25.01,25.03,7693,0
FJUL,6924,593,46.05,16,46.03,46.03,6924,0
EFUT,6892,500,22.45,500,22.30,22.51,6392,500
SMB,6797,500,17.17,600,17.16,17.17,6497,300
IGEB,6631,200,45.60,724,45.59,45.60,6631,0
NANC,6205,79,35.30,4,35.19,35.29,6205,0
CEMB,5847,700,45.07,733,45.05,45.05,5556,291
TTAI,5662,3000,29.69,1800,29.54,29.47,5662,0
BAUG,5576,5104,40.96,2400,40.91,40.92,5576,0
BTCL,5570,400,25.69,400,25.61,25.66,5570,0
TOKE,5507,600,6.10,600,5.98,6.10,5507,0
PTLC,5415,237,49.47,2000,49.43,49.45,5415,0
PJAN,5327,400,40.42,2600,40.33,40.29,5327,0
VIXM,5283,81,15.05,400,15.02,15.05,5283,0
IAGG,4933,1386,51.37,1300,51.36,51.36,4933,0
HYHG,4915,70,63.35,200,63.10,63.27,4894,21
EALT,4841,900,30.00,800,29.93,29.97,4841,0
PMAY,4799,500,34.30,700,34.23,34.20,4799,0
OUSM,4735,100,42.32,728,42.28,42.30,4735,0
IBHD,4701,477,23.20,1400,23.19,23.19,4701,0
ECH,4694,180,25.88,100,25.84,25.86,4694,0
IFRA,4684,600,43.77,200,43.73,43.73,4684,0
SECT,4651,16,51.21,1100,51.19,51.17,4651,0
GTIP,4580,500,49.28,100,49.22,49.28,4580,0
LKOR,4532,600,44.33,500,44.30,44.30,4532,0
NULV,4520,200,38.70,494,38.69,38.69,4444,76
FYLD,4502,100,26.24,300,26.19,26.23,4502,0
FCLD,4452,100,22.77,500,22.68,22.69,4451,1
SMDV,4406,200,65.83,600,65.78,65.77,4406,0
VTEC,4376,500,100.62,100,100.60,100.61,4376,0
YBTC,4345,600,44.68,600,44.59,44.64,4345,0
IBMO,4288,1100,25.52,1200,25.49,25.52,4288,0
IYZ,4272,1500,22.33,300,22.32,22.30,4272,0
JPLD,4250,700,51.76,2937,51.74,51.74,4250,0
PTMC,4248,400,35.06,743,35.02,34.97,4248,0
RPHS,4246,12,9.90,900,9.89,9.88,4246,0
FLDR,4224,200,50.24,23,50.23,50.24,4224,0
JEMA,4202,500,38.04,3300,37.96,37.98,4202,0
ITM,4011,100,46.46,784,46.45,46.46,3940,71
DDLS,3940,300,34.59,300,34.54,34.57,3940,0
SYLD,3933,200,68.34,138,68.26,68.30,3933,0
CEFS,3932,500,21.09,300,21.05,21.07,3932,0
FFOG,3837,500,35.46,500,35.39,35.43,3837,0
ICF,3828,300,61.95,204,61.93,61.89,3828,0
FMAY,3788,900,44.68,2800,44.61,44.61,3788,0
FLHY,3734,300,23.96,601,23.95,23.95,3734,0
FLIA,3724,618,20.61,800,20.60,20.61,3724,0
VFMV,3719,700,116.86,700,116.61,116.81,3719,0
BSEP,3702,6,40.96,600,40.86,40.81,3702,0
PAUG,3685,200,36.60,500,36.57,36.56,3685,0
WTAI,3505,2000,19.00,1700,18.96,18.94,3505,0
VXZ,3454,400,52.38,300,52.24,52.40,3454,0
MAMB,3427,500,22.94,400,22.91,22.92,3427,0
BBLB,3261,500,92.51,600,92.45,92.52,3261,0
BUFG,3244,300,23.21,500,23.15,23.19,3244,0
BBUS,3235,100,97.67,214,97.64,97.59,3235,0
ARKX,3177,100,14.55,200,14.53,14.49,3177,0
MSFX,3161,2677,26.81,400,26.76,26.79,3161,0
SHYD,3096,1,22.49,23,22.40,22.50,3096,0
DISV,3078,900,27.19,259,27.18,27.18,2419,659
GJUL,3072,800,34.84,900,34.76,34.81,3072,0
XTJL,2984,200,31.45,200,31.35,31.34,2984,0
PRNT,2924,10,19.22,600,19.09,19.08,2924,0
BUFF,2921,37,43.06,104,43.03,43.03,2303,618
HEGD,2913,500,21.31,787,21.27,21.30,2913,0
IGE,2844,600,43.72,600,43.70,43.69,2844,0
XSHQ,2825,300,40.28,409,40.17,40.23,2825,0
IBHJ,2800,1000,26.25,1000,26.19,26.22,2800,0
IETC,2793,200,72.85,113,72.80,72.75,2793,0
BBEM,2755,500,52.58,1000,52.51,52.49,2755,0
IPDP,2711,6900,18.46,6300,18.38,18.29,2711,0
VSGX,2670,196,57.79,74,57.74,57.72,2670,0
PFEB,2621,2146,35.29,3000,35.20,35.23,2621,0
IGRO,2607,200,69.51,400,69.32,69.46,2607,0
UFEB,2601,1500,31.81,3300,31.72,31.75,2601,0
DSCF,2600,500,23.06,500,23.03,23.05,2600,0
MEAR,2600,400,50.23,414,50.19,50.22,2500,100
FLQL,2589,620,54.98,1828,54.91,54.92,2589,0
RSSY,2559,100,20.23,100,20.17,20.16,913,1646
JULM,2517,900,30.58,700,30.50,30.54,2517,0
ISPY,2466,800,42.72,100,42.65,42.64,2466,0
GARP,2464,100,50.25,300,50.21,50.20,2464,0
GJUN,2438,1400,34.18,100,34.12,34.02,2438,0
BAPR,2411,400,41.43,400,41.33,41.27,2411,0
EZET,2377,2400,20.57,3075,20.54,20.61,2377,0
BRLN,2344,95,52.45,1200,52.27,52.38,2344,0
TMAT,2318,100,16.34,2300,16.30,16.29,2318,0
HEEM,2315,1100,26.77,1100,26.70,26.74,2315,0
EMTL,2310,100,42.83,600,42.81,42.83,2310,0
IGHG,2272,500,75.70,700,75.55,75.60,2272,0
UJUL,2249,1500,32.70,200,32.63,32.66,2249,0
FAUG,2234,900,44.54,2600,44.46,44.52,2234,0
WDNA,2200,100,16.18,100,16.13,16.11,2200,0
KRUZ,2180,2500,29.76,2500,29.64,29.62,2180,0
RSSB,2175,1000,23.39,500,23.31,23.29,2175,0
SMMV,2169,500,38.78,100,38.77,38.78,2169,0
VFMO,2167,600,149.64,1002,149.44,149.45,2167,0
UAPR,2103,997,29.04,400,29.01,29.04,2103,0
NULG,2076,751,78.32,200,78.27,78.25,2049,27
ACIO,2060,100,38.02,100,37.92,37.87,2060,0
BMAR,2056,100,43.15,700,43.05,43.00,2056,0
XEMD,2030,600,41.76,600,41.71,41.73,2030,0
NUSC,2009,300,40.21,200,40.19,40.17,2009,0
IYJ,1942,317,123.07,200,123.01,122.97,1942,0
FFLG,1916,1877,22.63,1100,22.59,22.57,1335,581
EMGF,1886,307,46.29,1200,46.27,46.23,1886,0
GAPR,1875,800,35.82,200,35.71,35.72,1875,0
GVI,1866,200,106.14,224,106.12,106.11,1866,0
CNYA,1848,500,25.10,1000,25.08,25.02,1848,0
KAPR,1829,400,31.25,100,31.18,31.18,1829,0
DRSK,1806,100,27.54,5100,27.48,27.53,1806,0
GAUG,1800,400,33.99,4100,33.91,33.94,1800,0
BUFS,1783,1000,20.29,1000,20.26,20.18,1783,0
TAIL,1773,700,12.24,1200,12.14,12.19,1536,237
PJUL,1746,1800,39.01,900,38.92,38.96,1746,0
FPFD,1722,512,21.75,600,21.73,21.74,1722,0
RULE,1704,1700,21.42,800,21.40,21.39,1704,0
DMAY,1651,400,38.52,2700,38.42,38.32,1651,0
BALT,1647,2100,30.17,100,30.14,30.15,1647,0
TMFG,1644,1900,30.43,1400,30.29,30.37,1644,0
XJUL,1638,1100,34.00,200,33.90,33.86,1638,0
MAXJ,1601,1000,25.36,10,25.27,25.33,1601,0
GSST,1597,600,50.39,700,50.38,50.38,1597,0
BUYW,1568,500,13.83,100,13.80,13.78,1568,0
QETH,1529,1900,27.07,2700,27.01,27.14,1529,0
NUEM,1526,200,28.86,200,28.64,28.79,1526,0
XVV,1512,500,41.71,676,41.67,41.52,1512,0
GFEB,1505,900,35.56,100,35.50,35.42,1505,0
IQDG,1478,1000,37.22,1000,37.19,37.06,1478,0
MSVX,1477,900,24.03,323,23.89,23.90,1477,0
ZAUG,1462,3655,24.14,500,24.08,24.09,1462,0
VTEI,1450,500,100.45,100,100.41,100.45,1450,0
RSST,1442,100,22.79,100,22.69,22.69,1442,0
UAUG,1415,582,33.76,1713,33.72,33.72,1415,0
IWMI,1398,500,48.83,1100,48.76,48.80,1398,0
DJUL,1394,710,39.83,321,39.77,39.81,1394,0
FRDM,1381,2500,34.78,1300,34.56,34.65,1381,0
IBMP,1368,1300,25.27,600,25.26,25.26,1368,0
REGL,1367,200,77.48,700,77.42,77.46,1367,0
DIVB,1338,1457,45.45,435,45.42,45.41,1338,0
GSUS,1331,100,74.35,1200,74.30,74.19,1331,0
IVRA,1328,1000,15.27,1000,15.22,15.26,1328,0
PJUN,1309,178,35.72,500,35.67,35.70,1309,0
ESG,1308,309,127.68,461,127.60,127.45,1308,0
JUNM,1295,700,30.75,5,30.67,30.69,1295,0
QJUN,1276,228,26.03,3800,25.95,25.99,1276,0
DECP,1269,3800,25.62,3800,25.54,25.60,1269,0
IYLD,1251,1000,20.10,1000,20.05,20.06,1251,0
SMMD,1249,200,63.55,300,63.45,63.52,1249,0
PSFF,1228,3500,27.90,100,27.78,27.83,1228,0
ZALT,1212,400,28.46,500,28.38,28.34,1212,0
PSFJ,1206,5,27.58,400,27.54,27.53,1206,0
QTJL,1179,2500,29.53,200,29.34,29.28,1179,0
BBIN,1143,500,59.29,700,59.22,59.24,1143,0
ADFI,1136,400,8.69,400,8.66,8.66,1136,0
GOOP,1134,3100,28.70,3100,28.60,28.57,1134,0
QHY,1129,100,45.41,725,45.37,45.37,1129,0
FDEV,1123,301,28.17,300,28.02,28.01,1123,0
NJUL,1104,2500,58.99,200,58.65,58.79,1104,0
PSCJ,1100,400,25.23,400,25.17,25.16,1100,0
MFUT,1081,1000,17.66,200,17.56,17.56,1081,0
VFVA,1053,700,113.90,100,113.79,113.62,1053,0
MOTI,1048,705,31.94,600,31.71,31.87,1048,0
GOLY,1047,900,23.86,1700,23.75,23.85,1047,0
PBUS,1046,500,54.13,632,54.11,54.12,1046,0
IBMN,1036,1500,26.62,1300,26.61,26.62,1036,0
BLKC,1015,300,19.71,800,19.64,19.67,1015,0
GHYG,1012,700,44.53,631,44.46,44.46,1012,0
BUFQ,1007,2500,29.40,200,29.23,29.30,1007,0
JULH,1001,1000,24.93,1200,24.87,24.86,1001,0
JANQ,1000,1200,24.81,1000,24.76,24.76,1000,0
XAUG,1000,800,33.14,999,33.09,33.11,1000,0
OGIG,999,99,37.95,400,37.94,37.95,999,0
DDWM,992,1000,34.05,1000,34.00,33.99,892,100
DUSA,992,100,39.47,600,39.38,39.46,992,0
MBCC,965,500,32.55,500,32.51,32.50,965,0
USMF,953,2912,46.27,1500,46.18,46.22,953,0
SMAY,945,400,23.69,1300,23.61,23.65,945,0
LQDW,929,600,28.32,1,28.31,28.30,929,0
STOT,927,1500,47.28,500,47.26,47.25,927,0
OUSA,926,200,50.62,302,50.60,50.59,767,159
XMAR,901,3200,34.76,3000,34.67,34.65,901,0
EWUS,898,400,37.06,300,36.99,36.93,898,0
VCEB,898,700,63.75,900,63.68,63.74,898,0
DAPR,894,592,35.47,385,35.38,35.26,894,0
KJUL,887,400,28.05,30,27.96,27.96,887,0
SDVD,887,298,20.98,500,20.94,20.94,887,0
HCRB,875,1000,35.71,635,35.68,35.66,875,0
IMFL,875,300,24.93,700,24.82,24.84,875,0
CLSE,873,2800,21.07,2500,21.01,21.03,873,0
BUFZ,865,5000,22.94,5053,22.90,22.93,865,0
FMAG,860,100,29.07,1100,29.02,29.00,787,73
DOGG,859,500,20.15,200,20.08,19.99,859,0
UJAN,857,500,37.24,4700,37.13,37.12,857,0
SVAL,849,795,30.49,700,30.45,30.41,849,0
ROMO,842,900,29.74,900,29.64,29.57,842,0
TJUL,839,400,27.00,900,26.97,26.98,839,0
QUVU,821,100,24.75,600,24.68,24.59,821,0
XDSQ,820,3200,33.16,3100,33.06,33.12,820,0
FCPI,819,266,40.91,2278,40.88,40.89,819,0
QBUL,809,2880,25.16,2400,25.06,25.16,809,0
BUYZ,801,800,31.69,800,31.61,31.57,801,0
PBP,798,100,22.17,300,22.12,22.10,798,0
YDEC,798,100,23.65,200,23.61,23.62,798,0
FFSM,792,1000,25.71,1100,25.68,25.60,792,0
XBJL,770,3100,32.42,3100,32.31,32.25,770,0
XJUN,770,3000,37.01,2800,36.92,36.94,770,0
GDE,769,200,35.25,200,34.93,34.92,769,0
GSEW,760,114,72.49,514,72.44,72.42,760,0
GOOX,759,300,29.65,745,29.59,29.60,759,0
WLDR,745,300,30.92,306,30.52,30.39,745,0
NUMG,742,319,41.42,792,41.34,41.36,742,0
HYGW,739,200,32.55,210,32.52,32.53,739,0
OSCV,737,391,35.79,479,35.76,35.73,737,0
ESGG,731,100,163.00,100,162.76,162.04,731,0
CAOS,730,100,85.71,1500,85.57,85.69,730,0
DAUG,726,1000,38.19,1100,38.12,38.16,726,0
FFEB,724,1000,46.90,2300,46.81,46.74,724,0
VAMO,715,900,28.52,900,28.44,28.44,715,0
PBTP,704,700,25.33,600,25.30,25.32,704,0
PSDM,701,600,51.03,600,50.99,50.97,701,0
DINT,690,300,20.04,800,19.94,19.96,690,0
DMAR,677,1803,36.07,644,35.99,36.04,677,0
POCT,663,4000,38.60,100,38.52,38.51,663,0
SEIV,661,61,30.71,2000,30.70,30.71,661,0
GAA,628,300,28.77,300,28.67,28.93,628,0
MSTB,627,100,32.89,2500,32.69,32.75,627,0
FPRO,621,400,22.77,100,22.73,22.72,621,0
PTEU,619,300,25.96,300,25.85,25.80,619,0
XAPR,617,400,31.24,1500,31.17,31.16,617,0
FDEC,615,228,42.69,311,42.63,42.61,615,0
NUMV,614,300,34.20,300,34.17,34.14,614,0
OILK,613,1800,46.49,1800,46.41,46.49,613,0
QCON,611,600,43.02,600,42.93,42.99,611,0
FPAG,603,2900,29.34,300,29.25,29.18,603,0
SAUG,574,400,22.27,300,22.19,22.14,574,0
OMFS,572,100,36.77,600,36.70,36.70,572,0
EVUS,570,300,28.02,300,27.99,27.94,570,0
FJAN,570,169,43.52,28,43.47,43.39,570,0
FJUN,567,400,48.39,500,48.30,48.30,567,0
YJUN,561,100,22.06,100,22.01,22.02,511,50
SEIQ,548,317,33.12,1000,33.08,33.02,548,0
DNOV,544,336,41.60,200,41.53,41.54,544,0
VFMF,543,600,123.52,700,123.28,123.42,543,0
QDEC,540,58,25.80,4400,25.76,25.76,540,0
SMOT,539,484,32.17,31,32.15,32.12,539,0
YMAR,531,200,23.32,49,23.25,23.20,531,0
GMOM,523,111,28.22,300,28.13,28.22,523,0
VFQY,516,600,134.71,700,134.46,134.47,516,0
BALI,514,500,28.95,500,28.90,28.69,514,0
CSM,514,900,61.20,2200,61.13,61.11,414,100
KOCT,511,400,29.11,300,29.02,28.98,511,0
MARM,507,135,29.89,200,29.82,29.86,507,0
DURA,505,200,33.20,200,33.17,33.13,505,0
DUBS,500,500,30.16,600,30.08,30.08,500,0
IBMR,496,128,25.20,500,25.19,25.20,496,0
IBHK,491,200,25.55,1000,25.50,25.49,491,0
XJR,490,500,39.29,1100,39.20,39.27,490,0
HYBL,487,800,28.23,600,28.19,28.20,487,0
BNOV,486,300,37.59,700,37.51,37.55,486,0
JANZ,484,2900,33.13,2900,33.00,33.08,484,0
BLDG,482,100,25.21,100,25.16,24.85,482,0
PMAR,472,218,38.06,600,38.04,38.02,472,0
PSMR,460,100,26.38,3700,26.33,26.32,460,0
EDEN,455,200,126.44,300,125.99,125.43,455,0
FCTR,447,281,28.38,1100,28.31,28.35,447,0
XDEC,435,481,36.22,200,36.16,36.21,435,0
VEGN,429,3100,47.96,4059,47.89,47.88,329,100
LEAD,412,200,65.07,400,64.98,64.94,412,0
RSBT,410,100,17.73,300,17.70,17.72,310,100
XDQQ,405,3200,29.91,4089,29.83,29.48,405,0
FDVL,404,200,11.93,1300,11.91,11.88,404,0
TILT,404,100,200.47,66,200.33,200.35,404,0
GMAY,385,400,35.09,200,35.01,34.85,385,0
BUFP,375,3600,25.34,3600,25.24,25.25,375,0
FSEP,366,2600,44.04,2200,43.95,43.90,366,0
ENOR,364,300,24.44,200,24.36,24.31,364,0
XSEP,363,100,37.99,600,37.91,37.97,363,0
SATO,359,1000,14.23,1000,14.20,14.25,359,0
PAWZ,356,149,55.12,300,55.07,55.09,356,0
JANJ,349,1000,24.87,1000,24.83,24.82,349,0
GMAR,335,400,35.60,2000,35.53,35.51,335,0
PEX,335,500,27.86,25,27.80,27.80,334,1
FLQS,325,200,39.83,200,39.78,39.75,325,0
HIYS,320,600,25.66,600,25.61,25.62,320,0
QPFF,319,305,36.42,200,36.29,36.39,319,0
QTAP,318,100,34.26,100,34.19,33.95,318,0
BJUL,317,603,41.79,500,41.73,41.73,317,0
JUCY,308,500,23.39,600,23.34,23.38,308,0
AESR,304,100,16.13,900,16.11,16.12,304,0
PAPR,300,500,34.67,700,34.60,34.64,300,0
XUSP,300,600,36.45,600,36.33,36.40,300,0
JPIB,299,500,47.93,600,47.87,47.88,299,0
FMAR,298,1100,40.64,700,40.53,40.53,298,0
BTCZ,295,500,19.18,500,19.11,19.15,295,0
QSPT,292,3700,26.08,3900,25.96,25.96,292,0
FDRV,282,100,12.62,600,12.55,12.45,282,0
EYLD,279,500,33.53,300,33.31,33.20,279,0
PSFD,266,3100,31.58,3100,31.50,31.48,266,0
DWLD,264,1000,33.06,700,32.95,32.97,264,0
IWMW,257,400,44.84,200,44.72,44.57,257,0
ISVL,254,250,35.55,250,35.43,35.40,254,0
GDMN,253,100,31.97,200,31.72,31.91,253,0
BBSA,251,600,48.37,500,48.32,48.35,251,0
XFEB,248,400,31.52,1500,31.44,31.44,248,0
MBNE,247,500,30.01,497,29.95,29.99,247,0
TDV,245,300,72.93,200,72.87,72.90,245,0
QLC,241,500,61.46,500,61.38,61.30,241,0
TUSI,239,100,25.40,700,25.36,25.38,239,0
DJUN,235,400,40.97,800,40.87,40.68,235,0
GOCT,231,4000,34.35,3200,34.26,34.32,231,0
XJH,229,500,39.85,600,39.75,39.78,229,0
PDEC,226,100,37.66,2800,37.62,37.65,226,0
OBND,224,500,26.10,600,26.09,26.10,224,0
BUFB,222,500,30.63,1500,30.51,30.62,222,0
DFRA,222,725,30.43,900,30.37,30.38,222,0
TSLP,221,4900,21.93,4900,21.84,21.92,221,0
SEIM,215,2300,33.13,2400,33.08,33.10,181,34
ATMP,210,300,25.04,2300,25.00,24.99,210,0
HELX,209,600,32.58,600,32.45,32.53,209,0
MVFD,206,500,24.89,767,24.85,24.88,206,0
NURE,205,335,32.22,900,32.17,32.10,205,0
VHAI+B,202,100,22.18,100,15.00,15.00,202,0
RVRB,201,1800,28.21,100,28.19,28.12,201,0
EFNL,200,100,35.49,100,35.37,35.28,200,0
FOCT,200,900,41.77,200,41.67,41.69,200,0
GSEP,200,400,34.05,900,33.96,33.98,200,0
NXTV,200,100,25.65,1100,25.63,25.62,200,0
PBL,200,200,28.37,100,28.19,28.27,200,0
PSH,200,500,50.25,500,50.20,50.16,200,0
XISE,200,200,30.41,200,30.32,30.40,200,0
UOCT,196,900,34.53,3000,34.44,34.45,196,0
BJAN,192,400,45.20,2400,45.11,44.84,192,0
HYIN,191,400,18.56,5,18.51,18.51,46,145
IEDI,189,300,47.77,300,47.71,47.55,189,0
TBJL,186,300,20.77,100,20.70,20.71,186,0
BUSA,183,300,30.30,2800,30.24,30.08,183,0
DFNL,183,300,34.17,300,34.07,34.05,183,0
NJAN,181,2100,45.12,700,45.00,44.89,181,0
TFJL,181,100,20.81,100,20.77,20.74,181,0
AMZP,168,3100,27.68,3100,27.59,27.63,168,0
OCTQ,167,4000,24.11,4200,24.02,24.04,167,0
QTJA,167,100,23.53,1100,23.47,23.45,161,6
XTAP,163,100,32.36,300,32.28,32.08,163,0
ARKY,150,500,33.23,500,33.05,32.53,150,0
EGUS,150,200,39.34,200,39.31,39.20,92,58
VHAI+A,150,100,1.44,100,0.51,1.09,150,0
XOCT,150,800,33.62,929,33.52,33.46,150,0
JAJL,144,400,26.21,2000,26.17,26.19,144,0
FAPR,143,1302,39.12,700,39.01,38.95,143,0
MVAL,134,500,31.38,500,31.36,31.13,134,0
TGLR,132,1800,27.62,2035,27.52,27.38,132,0
RTAI,130,2200,22.16,2200,22.07,22.10,130,0
BBRE,128,309,94.52,700,94.44,94.49,128,0
FRNW,127,500,15.06,500,14.99,15.01,127,0
XMPT,127,500,22.53,300,22.48,22.42,127,0
BINV,120,1000,30.45,2000,30.33,30.20,120,0
FBUF,119,1000,25.40,1000,25.35,25.55,119,0
WEED,119,300,30.25,300,29.86,30.20,119,0
MDEV,116,100,20.70,1000,20.64,20.59,116,0
APRH,115,200,24.82,4100,24.70,24.71,115,0
DFEB,115,400,40.47,2600,40.38,40.39,115,0
STBF,115,600,25.33,1400,25.32,25.33,115,0
DOCT,110,400,38.66,200,38.56,38.62,110,0
FNOV,110,400,46.22,100,46.14,46.09,110,0
ZJUL,110,412,26.18,4162,26.09,26.15,110,0
FBCV,109,900,30.90,200,30.79,30.81,109,0
BBIB,106,2600,99.35,609,99.30,99.35,106,0
BAMA,104,200,29.43,800,29.42,29.42,104,0
GEMD,103,500,41.43,600,41.39,41.41,103,0
NULC,102,200,43.37,200,43.32,43.08,102,0
DECZ,101,2700,35.40,2700,35.29,35.18,101,0
OCTH,101,3900,24.20,4100,24.10,24.16,101,0
SNOV,101,100,22.13,1200,22.10,22.02,101,0
XBOC,101,3400,29.51,3400,29.40,29.44,101,0
APRJ,100,200,24.82,4100,24.69,24.70,100,0
BCHP,100,1500,31.19,1500,31.15,31.01,100,0
BFEB,100,1467,40.75,2600,40.66,40.49,100,0
BSMC,100,1000,29.46,1000,29.34,29.15,100,0
GDMA,100,900,31.17,4800,31.11,31.10,100,0
GJAN,100,800,37.06,200,36.96,36.93,100,0
JULJ,100,1000,24.98,1200,24.90,24.93,100,0
MYLD,100,100,25.78,300,25.73,25.64,100,0
RMIF,100,100,25.11,800,25.06,25.04,100,0
XBAP,100,100,32.38,3100,32.30,32.29,100,0
XBJA,100,3500,27.80,3600,27.71,27.74,100,0
XIDE,100,200,30.32,200,30.23,30.30,100,0
XTJA,100,200,26.62,200,26.54,26.59,100,0
TTAC,99,1000,61.19,800,61.08,60.80,99,0
MDLV,96,900,25.92,900,25.84,25.78,96,0
XDJL,94,3100,32.31,3100,32.21,32.05,94,0
EAOA,93,300,34.68,300,34.64,34.44,93,0
HAUS,87,2600,18.95,2600,18.91,19.04,87,0
JCPI,85,600,47.36,3102,47.32,47.52,85,0
SHAG,84,100,47.81,700,47.77,47.79,84,0
OCTJ,82,4000,24.14,4200,24.04,24.06,82,0
BEMB,81,500,52.76,600,52.71,52.74,81,0
MOHR,79,200,20.21,200,20.19,20.13,79,0
GCLN,78,100,34.87,200,34.68,34.60,78,0
BMAY,76,3100,38.07,2800,37.96,37.89,76,0
FIBR,76,600,87.37,568,87.27,87.26,76,0
HYXU,72,600,50.82,600,50.75,50.79,72,0
MVFG,71,300,26.23,300,26.19,26.16,71,0
NAUG,70,400,24.23,800,24.17,24.03,70,0
TDVI,69,500,23.71,513,23.66,23.61,69,0
WUGI,69,1000,66.44,1000,66.13,65.42,69,0
IGLD,68,100,20.66,338,20.63,20.60,68,0
ARKA,65,500,56.51,500,56.45,55.12,65,0
XDAT,65,800,22.35,900,22.27,22.14,65,0
PWS,60,500,29.88,500,29.84,29.85,60,0
PIT,57,300,47.97,300,47.86,47.83,57,0
BAMO,55,800,28.89,800,28.86,28.70,55,0
DSEP,54,2900,39.42,2700,39.31,39.35,54,0
USEP,53,500,34.06,800,33.98,34.01,53,0
IZRL,52,196,19.30,1,19.19,19.19,52,0
AAPY,50,3800,27.04,3800,26.94,26.94,50,0
HFGO,50,400,20.32,400,20.28,20.08,50,0
LQDI,50,500,26.19,600,26.05,26.23,50,0
MDPL,50,500,25.43,500,25.39,25.48,50,0
ARKZ,49,500,31.45,500,31.40,31.65,49,0
PSFM,49,3500,27.93,3500,27.83,27.71,49,0
UJUN,48,1400,32.10,500,32.05,32.06,48,0
KWT,47,200,31.85,200,31.64,31.79,47,0
AJAN,45,10,25.62,200,25.55,25.56,45,0
IVVB,43,500,28.66,500,28.59,28.52,43,0
DJAN,41,100,37.26,700,37.19,37.17,41,0
BGLD,40,25,21.47,1,21.43,21.39,40,0
FYEE,38,1000,25.31,1000,25.28,25.25,38,0
NFLP,32,3000,30.48,3000,30.41,30.42,32,0
MSFY,31,3400,26.12,3400,26.04,25.92,31,0
HOCT,30,100,23.95,700,23.92,23.94,30,0
SNAV,29,900,29.14,880,29.08,28.92,29,0
RDFI,28,2976,24.20,3000,24.12,24.19,28,0
FDEM,26,500,25.79,300,25.75,25.75,26,0
IDUB,26,300,20.69,307,20.62,20.56,26,0
NUDM,24,200,31.47,739,31.32,31.33,24,0
DFNV,23,1600,31.30,1600,31.25,31.18,23,0
DFHY,22,1000,21.30,878,21.26,21.23,22,0
INTL,22,1100,22.43,1000,22.38,22.30,22,0
LOCT,21,700,23.92,699,23.87,23.91,21,0
NJUN,20,3800,25.66,4000,25.57,25.51,20,0
HSRT,19,100,39.06,600,39.00,39.06,19,0
ACSI,15,2800,55.20,2800,55.15,55.15,15,0
JULZ,13,28,40.30,2400,40.25,40.19,13,0
ARKC,11,500,37.48,500,37.31,36.68,11,0
BUFT,11,500,21.95,200,21.91,21.89,11,0
FHEQ,10,1000,25.87,1000,25.83,25.82,10,0
IVVM,10,500,28.94,500,28.87,28.72,10,0
NDOW,10,900,24.82,900,24.70,24.34,10,0
AFIF,9,4000,9.19,4200,9.16,9.16,9,0
BAMG,9,1000,31.47,800,31.43,31.28,9,0
HEAT,9,1000,25.13,1000,25.04,24.87,9,0
SELV,9,100,27.92,1000,27.91,27.92,9,0
INAV,8,900,26.35,892,26.29,26.24,8,0
VMAX,8,100,46.62,100,46.56,46.43,8,0
WBAT,8,100,24.85,100,24.75,24.57,8,0
AAPR,7,1100,25.52,1300,25.48,25.50,7,0
IQM,7,600,60.00,600,59.83,59.57,7,0
RSEE,6,3000,29.33,3100,29.24,28.61,6,0
BAMV,5,201,29.85,800,29.83,29.72,5,0
GHTA,4,900,28.11,1000,27.97,27.94,4,0
GVAL,4,300,21.00,300,20.83,20.80,4,0
MARZ,4,3200,30.88,3200,30.77,30.66,4,0
TMFM,4,1800,27.50,1800,27.45,27.38,4,0
BKGI,3,300,30.32,500,30.25,30.30,3,0
JULQ,3,1000,24.97,1100,24.92,24.95,3,0
SHDG,3,100,27.34,100,27.25,27.12,3,0
ZECP,3,1700,29.22,1700,29.18,29.21,3,0
BAMD,2,802,31.02,900,30.98,30.79,2,0
BAMY,2,900,26.35,1000,26.32,26.18,2,0
GLOV,2,400,47.85,800,47.68,47.48,2,0
MAGA,2,300,45.90,2000,45.83,45.71,2,0
MFUL,2,1700,21.67,900,21.64,21.52,2,0
MOTE,2,600,27.07,600,27.02,26.93,2,0
NOVZ,2,2500,38.81,2500,38.70,38.60,2,0
OEUR,2,500,30.18,600,30.10,29.81,2,0
PNOV,2,100,36.55,700,36.48,36.48,2,0
RODE,2,200,27.99,200,27.89,27.79,2,0
SNPG,2,700,41.40,700,41.32,40.99,2,0
TSLH,2,4100,26.69,4100,26.60,26.50,2,0
BAMB,1,100,26.56,900,26.54,26.44,1,0
BAMU,1,1300,25.46,900,25.42,25.42,1,0
BBIP,1,2000,97.63,2000,97.55,97.60,1,0
CMCI,1,100,24.38,100,24.22,24.45,1,0
DFND,1,100,40.16,1,38.05,39.62,1,0
EAOR,1,300,30.92,300,30.88,30.72,1,0
EMDV,1,200,43.40,200,43.20,43.13,1,0
EPRF,1,800,18.68,1400,18.63,18.59,1,0
FDND,1,1800,18.54,1800,18.43,18.45,1,0
HJAN,1,3900,24.71,4100,24.61,24.73,1,0
IVVW,1,800,49.10,200,49.00,48.55,1,0
MOTG,1,1000,37.60,500,37.55,37.22,1,0
NOCT,1,500,49.23,300,49.14,49.09,1,0
NXTI,1,1100,26.42,800,26.37,26.32,1,0
PSEP,1,500,37.80,600,37.71,37.73,1,0
QIG,1,700,45.22,700,45.15,45.12,1,0
QTOC,1,3100,27.75,3000,27.49,27.60,1,0
RYSE,1,700,22.85,3700,22.77,22.81,1,0
SEPZ,1,2600,37.17,2600,37.06,36.87,1,0
TMFS,1,1600,31.47,2100,31.40,31.30,1,0
UMAR,1,700,33.74,200,33.66,33.51,1,0
ADME,0,500,43.94,3200,43.83,0.00,0,0
APRD,0,4000,24.79,4000,24.68,0.00,0,0
APRP,0,3800,25.94,3800,25.83,0.00,0,0
APRQ,0,200,24.78,4100,24.64,0.00,0,0
APRZ,0,2900,33.18,2900,33.07,0.00,0,0
ARCM,0,1000,100.51,1000,100.39,0.00,0,0
ARKD,0,500,39.35,500,39.19,0.00,0,0
ARLU,0,400,25.65,200,25.58,0.00,0,0
AUGP,0,3800,25.59,3800,25.50,0.00,0,0
AUGU,0,400,24.73,200,24.67,0.00,0,0
AUGZ,0,2600,37.80,2600,37.70,0.00,0,0
BBSB,0,2000,99.00,2000,98.92,0.00,0,0
BDEC,0,2700,42.06,2500,41.96,0.00,0,0
BHYB,0,600,54.01,600,53.96,0.00,0,0
BJUN,0,400,39.08,500,39.01,0.00,0,0
BOCT,0,900,41.85,700,41.77,0.00,0,0
BWTG,0,1500,32.25,1500,32.15,0.00,0,0
CFCV,0,2000,36.11,900,35.71,0.00,0,0
CVAR,0,900,25.80,100,25.50,0.00,0,0
DDEC,0,993,38.67,700,38.57,0.00,0,0
DWAT,0,1000,10.90,1000,10.87,0.00,0,0
DWCR,0,900,29.88,900,29.65,0.00,0,0
EAOK,0,300,25.75,100,25.73,0.00,0,0
EAOM,0,400,27.50,400,27.47,0.00,0,0
EFAD,0,500,39.49,300,39.37,0.00,0,0
EUDV,0,20,49.25,200,49.19,0.00,0,0
FAIL,0,33,17.15,900,16.87,0.00,0,0
FDCE,0,1200,11.94,800,11.92,0.00,0,0
FDGR,0,1100,12.29,800,12.27,0.00,0,0
FDHT,0,600,18.80,500,18.73,0.00,0,0
FDTB,0,200,9.59,900,9.52,0.00,0,0
FEBP,0,3600,27.04,3600,26.95,0.00,0,0
FEBZ,0,5,33.62,2900,33.52,0.00,0,0
FFLV,0,1500,20.80,1000,20.78,0.00,0,0
FLDZ,0,5300,26.12,5300,26.05,0.00,0,0
FUNL,0,700,39.17,700,39.12,0.00,0,0
GDEC,0,400,32.60,3200,32.50,0.00,0,0
GHEE,0,100,26.10,100,26.02,0.00,0,0
GHMS,0,100,26.21,500,26.14,0.00,0,0
GNOV,0,500,33.94,200,33.85,0.00,0,0
GPOW,0,900,47.37,300,47.27,0.00,0,0
GSEE,0,1000,45.34,1000,45.00,0.00,0,0
GSID,0,400,56.20,900,55.95,0.00,0,0
HAPR,0,700,25.07,700,25.01,0.00,0,0
HJUL,0,2000,23.81,2000,23.75,0.00,0,0
HSUN,0,500,34.64,500,34.61,0.00,0,0
HYKE,0,600,25.77,700,25.71,0.00,0,0
IBMS,0,600,25.60,600,25.55,0.00,0,0
IMSI,0,700,51.54,700,51.38,0.00,0,0
IPPP,0,10600,10.03,10600,9.97,0.00,0,0
ISDB,0,700,25.14,700,25.10,0.00,0,0
JAND,0,1500,25.02,1501,24.98,0.00,0,0
JANH,0,1000,24.94,1000,24.90,0.00,0,0
JANP,0,3600,27.44,3600,27.35,0.00,0,0
JNEU,0,400,25.61,200,25.54,0.00,0,0
JULD,0,1000,24.93,1000,24.87,0.00,0,0
JULP,0,3800,25.52,3800,25.46,0.00,0,0
JULU,0,400,24.97,200,24.91,0.00,0,0
JUNP,0,3800,25.67,3800,25.56,0.00,0,0
JUNZ,0,3300,29.03,3300,28.93,0.00,0,0
KAUG,0,400,24.03,1000,23.95,0.00,0,0
KJUN,0,400,25.65,700,25.59,0.00,0,0
KNOW,0,200,10.43,200,10.33,0.00,0,0
LAPR,0,700,25.08,700,25.03,0.00,0,0
LBO,0,700,28.46,700,28.41,0.00,0,0
LCF,0,100,33.79,300,33.74,0.00,0,0
LJAN,0,3900,24.68,4100,24.58,0.00,0,0
LJUL,0,4100,23.88,4100,23.78,0.00,0,0
LYLD,0,2900,25.34,2900,25.28,0.00,0,0
MAYP,0,3700,26.44,3700,26.36,0.00,0,0
MAYU,0,400,26.60,200,26.53,0.00,0,0
MAYZ,0,3400,28.87,3400,28.76,0.00,0,0
MBBB,0,100,21.68,600,21.63,0.00,0,0
MBND,0,700,27.79,500,27.69,0.00,0,0
MGRO,0,500,29.15,500,29.13,0.00,0,0
MIG,0,600,21.63,600,21.57,0.00,0,0
MINN,0,100,22.38,900,22.19,0.00,0,0
MRCP,0,3700,26.42,4700,26.35,0.00,0,0
MRGR,0,500,41.29,10,41.18,0.00,0,0
MSMR,0,4500,29.14,4500,29.06,0.00,0,0
MSSS,0,300,26.80,300,26.76,0.00,0,0
MSTQ,0,100,32.11,2500,31.87,0.00,0,0
NAPR,0,2500,47.33,300,47.03,0.00,0,0
NOVP,0,3800,25.50,3800,25.43,0.00,0,0
NUDV,0,400,27.66,400,27.63,0.00,0,0
OCTD,0,4100,24.29,4100,24.18,0.00,0,0
OCTP,0,3800,25.67,3800,25.48,0.00,0,0
OCTZ,0,2600,37.22,2600,37.13,0.00,0,0
PBAP,0,3800,25.86,3800,25.78,0.00,0,0
PBAU,0,3800,25.62,3800,25.55,0.00,0,0
PBDE,0,3800,25.56,3800,25.48,0.00,0,0
PBFB,0,3700,26.63,3700,26.55,0.00,0,0
PBFR,0,3800,25.34,3800,25.26,0.00,0,0
PBJA,0,3600,26.90,3600,26.81,0.00,0,0
PBJL,0,3800,25.57,3800,25.50,0.00,0,0
PBJN,0,3800,25.60,3800,25.52,0.00,0,0
PBMR,0,3700,26.24,3700,26.15,0.00,0,0
PBMY,0,3700,26.20,3700,26.13,0.00,0,0
PBNV,0,3800,25.47,3800,25.39,0.00,0,0
PBOC,0,3800,25.53,3800,25.45,0.00,0,0
PBSE,0,3800,25.61,3800,25.53,0.00,0,0
PJBF,0,1000,59.07,1000,58.93,0.00,0,0
PJFM,0,500,53.08,500,52.98,0.00,0,0
PSCQ,0,5,25.83,200,25.79,0.00,0,0
PSCW,0,4000,24.65,4000,24.56,0.00,0,0
PSCX,0,3700,26.52,3700,26.43,0.00,0,0
PSFO,0,200,27.89,200,27.82,0.00,0,0
PSMD,0,3500,27.99,3500,27.89,0.00,0,0
PSMJ,0,400,26.99,400,26.92,0.00,0,0
PSMO,0,100,26.85,200,26.84,0.00,0,0
PUTD,0,1000,22.40,100,22.29,0.00,0,0
QBER,0,5400,25.25,2,25.17,0.00,0,0
QCAP,0,1100,21.09,1100,21.02,0.00,0,0
QSIG,0,100,48.54,600,48.49,0.00,0,0
QVOY,0,900,26.75,900,26.71,0.00,0,0
RBUF,0,200,25.41,2212,25.37,0.00,0,0
ROIS,0,1000,50.55,1000,50.33,0.00,0,0
RTRE,0,300,25.75,300,25.71,0.00,0,0
SCLZ,0,500,52.02,400,51.91,0.00,0,0
SEPP,0,3800,25.68,3800,25.60,0.00,0,0
SFEB,0,400,20.44,300,20.38,0.00,0,0
SMI,0,800,46.68,700,46.61,0.00,0,0
SNPD,0,700,26.49,700,26.47,0.00,0,0
SNPV,0,700,30.36,700,30.33,0.00,0,0
SPCZ,0,900,26.79,900,26.40,0.00,0,0
SPMV,0,100,44.31,500,44.23,0.00,0,0
TMDV,0,300,47.40,300,47.32,0.00,0,0
TOLL,0,200,32.41,200,32.29,0.00,0,0
TYLD,0,900,25.48,600,25.44,0.00,0,0
UDEC,0,3300,34.43,700,34.32,0.00,0,0
UMAY,0,265,32.02,3200,31.96,0.00,0,0
UNOV,0,400,33.55,400,33.45,0.00,0,0
VIRS,0,500,37.43,500,37.29,0.00,0,0
VWID,0,1000,27.14,1000,27.11,0.00,0,0
XDAP,0,3100,33.03,4159,32.91,0.00,0,0
XDJA,0,3700,27.25,3700,27.14,0.00,0,0
XDOC,0,3400,29.38,3400,29.27,0.00,0,0
XIJN,0,500,30.67,300,30.58,0.00,0,0
XIMR,0,900,31.04,900,30.94,0.00,0,0
XJAN,0,1000,32.68,800,32.58,0.00,0,0
XMAY,0,400,30.30,200,30.22,0.00,0,0
XNOV,0,3300,33.28,2900,33.20,0.00,0,0
XTOC,0,300,28.53,300,28.44,0.00,0,0
XVOL,0,100,20.86,100,20.37,0.00,0,0
YSEP,0,400,21.69,200,21.61,0.00,0,0